11111111111111111111
1P000000000000001E11
11111110111110111111
10000000100000000001
11111000101111111001
1C0000010000000000C1
10111111110111111101
10000000000000000001
1C1111110111111111C1
11111111111111111111
